000021111111111111111111111111111111111111111111111111111111111111111111
000021111111111111111111111111111111111111111111111111111111111111111111
000021111111111111111111111111111111111111111111111111111111111111111111
000021111111111111111111111111111111111111111111111111111111111111111111
000021111111111111111111111111111111111111111111111111111111111111111111
000022222222222222222222222222222222111111111111111111111111111111111111
000000000000000000000000000000000002111111111111111111111111111111111111
000000000000000000000000000000000002111111111111111111111111111111111111
000000000000000000000000000000000002111111111111111111111111111111111111
000000000000000000000000000000000002111111111111111111111111111111111111
000000000000000000000000000000000002111111111111111111111111111111111111
22222222222222222222222222222000000211111111122222222222222222222222222222222222222222222222222222222222222
11111111111111111111111111112000000211111111122222222222222222222222222222222222222222222222222222222222222
11111111111111111111111111112000000211111111122222222222222222222222222222222222222222222222222222222222222
11111111111111111111111111112000000211111111122222222222222222222222222222222222222222222222222222222222222
11111111111111111111111111112000000211111111122222222222222222222222222222222222222222222222222222222222222
11111111111111111111111111112000000211111111122222222222222222222222222222222222222222222222222222222222222
11111111111111111111111111112000000211111111122222222222222222222222222222222222222222222222222222222222222
11111111111111111111111111112000000211111111122222222222222222222222222222222222222222222222222222222222222
11111111111111111111111111112000000211111111122222222222222222222222222222222222222222222222222222222222222
11111111111111111111111111112000000222222222222222222222222222222222222222222222222222222222222222222222222
11111111111111111111111111112000000000000000000000000000000000000000000000000000000000000000000000000000002
11111111111111111111111111112000000000000000000000000000000000000000000000000000000000000000000000000000002
11111111111111111111111111112000000000000000000000000000000000000000000000000000000000000000000000000000002
11111111111111111111111111112000000000000000000000000000000000000000000000000000000000000000000000000000002
11111111111111111111111111112222222222222222222222222222222222222222222222222222222222222222222222222222222
11111111111111111111111111112222222222222222222222222222222222222222222222222222222222222222222222222222222
11111111111111111111111111112222222222222222222222222222222222222222222222222222222222222222222222222222222
22222222222222222222222222222222222222222222222222222222222222222222222222222222222222222222222222222222222
22222222222222222222222222222222222222222222222222222222222222222222222222222222222222222222222222222222222
22222222222222222222222222222222222222222222222222222222222222222222222222222222222222222222222222222222222
22222222222222222222222222222222222222222222222222222222222222222222222222222222222222222222222222222222222
22222222222222222222222222222222222222222222222222222222222222222222222222222222222222222222222222222222222
